20
20
>...................
*******************.
.******************.
*******************.
*******************.
.**..**..**..**..**.
.**..**..**..**..**.
....................
....................
.**..**..**..**..**.
...........********.
....................
....................
.**...............*.
.**..**..**..**..**.
....................
....................
.**..**..**..**..**.
.**..**..**..**..**.
...................x